######
#.   #
#  $ #
#  @ #
#    #
######
