######
#    #
#    #
#  $.#
#@ # #
######
