######
#   .#
#  $ #
# $  #
#.  @#
######