#######
#  .  #
# $*$$#
# ..$.#
#@* $ #
##.   #
#######