#######
#   ###
#  *  #
#   $ #
#  $..#
###@  #
#######