#######
#   ###
#  ** #
#   $ #
#  $..#
###@  #
#######